ampqu_4652	A.queenslandica	Amphimedon queenslandica
aspni	A.nidulans	Aspergillus nidulans
ath	A.thaliana	Arabidopsis thaliana
batde	B.dendrobatidis	Batrachochytrium dendrobatidis
canal	C.albicans	Candida albicans
capow	C.owczarzaki	Capsaspora owczarzaki
cho	C.hominis	Cryptosporidium hominis
cre	C.reinharditii	Chlamydomonas reinhardtii
lacbi	L.bicolor	Laccaria bicolor
monbr	M.brevicollis	Monosiga brevicollis
mucci	M.circinelloides	Mucor circinelloides
nemve	N.vectensis	Nematostella vectensis
neucr	N.crassa	Neurospora crassa
ngr	N.gruberi	Naegleria gruberi
pfa	P.falciparum	Plasmodium falciparum
phybl	P.blakesleeanus	Phycomyces blakesleeanus
psoj	P.sojae	Phytophthora sojae
pucgr	P.graminis	Puccinia graminis
rhior	R.oryzae	Rhizopus oryzae
rozal	R.allomyces	Rozella allomyces
sacce	S.cerevisiae	Saccharomyces cerevisiae
schpo	S.pombe	Schizosaccharomyces pombe
spipu	S.punctatus	Spizellomyces punctatus
trybr	T.brucei	Trypanosoma brucei
enche_5516	E.hellem	Encephalitozoon hellem
encin_5517	E.intestinalis	Encephalitozoon intestinalis
enccu_2934	E.cuniculi	Encephalitozoon cuniculi
nosce_4242	N.ceranae	Nosema ceranae
entbi_4241	E.bieneusi	Enterocytozoon bieneusi
vitco_5050	V.corneae	Vittaforma corneae
annca_339	A.algerae	Anncaliia algerae
antlo_2712	A.locustae	AntonosporaÂ locustae
edhae_4124	E.aedis	Edhazardia aedis
vavcu_5255	V.culicis	Vavraia culicis floridensis
nempa_5256	N.parisii	Nematocida parisii
